AIR	    AIR	    AIR	    BRICK   BRICK   BRICK   AIR	    AIR	    BRICK   AIR	    AIR	    AIR	    AIR
AIR	    BRICK   BRICK   BRICK   BRICK   BRICK   BRICK   BRICK   BRICK   BRICK   AIR	    AIR	    AIR
AIR	    TREE    TREE    TREE    TREE    TREE    TREE    TREE    TREE    BRICK   BRICK   AIR	    AIR
TREE    TREE    AIR	    AIR	    AIR	    AIR	    AIR	    AIR	    TREE    TREE    BRICK   BRICK   AIR
TREE    AIR	    WALL    AIR	    AIR	    WALL    AIR	    AIR	    AIR	    TREE    TREE    TREE    AIR
TREE    AIR	    WALL    AIR	    AIR	    WALL    AIR	    AIR	    AIR	    TREE    TREE    TREE    AIR
TREE    AIR	    AIR     TREE    AIR	    AIR     AIR	    AIR	    TREE    TREE    TREE    BRICK   BRICK
TREE    TREE    TREE    TREE    TREE    TREE    TREE    TREE    TREE    BRICK   BRICK   BRICK   BRICK
BRICK   TREE    TREE    BRICK   BRICK   TREE    TREE    TREE    BRICK   BRICK   BRICK   BRICK   AIR
AIR	    BRICK   BRICK   BRICK   BRICK   BRICK   BRICK   BRICK   BRICK   BRICK   BRICK   AIR	    WALL
WALL    AIR     BRICK   WALL    BRICK   BRICK   BRICK   BRICK   BRICK   BRICK   BRICK   AIR	    WALL
AIR     WALL    BRICK   BRICK   AIR     AIR     AIR     BRICK   BRICK   BRICK   WALL    WALL    WALL
AIR	    AIR	    AIR	    AIR	    AIR	    AIR	    AIR	    AIR	    AIR	    AIR	    AIR	    AIR	    AIR